############################
#111111111111##111111111111#
#1####1#####1##1#####1####1#
#2####1#####1##1#####1####2#
#1####1#####1##1#####1####1#
#11111111111111111111111111#
#1####1##1########1##1####1#
#1####1##1########1##1####1#
#111111##1111##1111##111111#
######1#####-##-#####1######
-----#1#####-##-#####1#-----
-----#1##----------##1#-----
-----#1##-###--###-##1#-----
######1##-#------#-##1######
------1---#------#---1------
######1##-#------#-##1######
-----#1##-########-##1#-----
-----#1##----3-----##1#-----
-----#1##-########-##1#-----
######1##-########-##1######
#111111111111##111111111111#
#1####1#####1##1#####1####1#
#1####1#####1##1#####1####1#
#211##1111111111111111##112#
###1##1##1########1##1##1###
###1##1##1########1##1##1###
#111111##1111##1111##111111#
#1##########1##1##########1#
#1##########1##1##########1#
#11111111111111111111111111#
############################
