############################
1111111111111111111111111111
1111111111111111111111111111
1111111111111111111111111111
1111111112111111211111111111
1111111111111111111111111111
1111111111111111111111111111
1111111111111111111111111111
1111111111111111111111111111
1111111111111111111111111111
1111111111111111111111111111
1111111111111111111111111111
1111111111###11###1111111111
1111111111#111111#1111111111
1111111111#111111#1111111111
1111111111#111111#1111111111
1111111111########1111111111
1111111111111111111111111111
1111111111111131111111111111
1111111111111111111111111111
1111111111111111111111111111
1111111111111111111111111111
1111111111111##1111111111111
1111111111111111111111111111
1111111111111##1111111111111
1111111111111111111111111111
1111111111111111111111111111
1111111111111111111111111111
1111111111111111111111111111
1111111111111111111111111111
############################
